dim:16
health:50
score:2000
1,1,1,1,1,1,1,1,1,1,1,1,1,1,1,1
1, , , , , , , , , , , , , , ,1
1, , , , ,o, , , , , , ,o, , ,1
1,2,2,2,2,2,2, , , , , , , , ,1
1,#, , , , ,3, , , , , ,p, , ,1
1, ,k, , , ,2, , , , , , , , ,1
1,4, ,h, , ,2, , , , , ,4,4,4,1
1,2,2,4,4,4,2,m, , , , ,4,4,4,1
1,x,2,2,1,1,1,2,3,2,1,2,2,1,2,1
1, , , , , , , , , , , , , ,+,1
1, , ,+, , , , , , , , , , , ,1
1, ,o, , , , , , , , , , ,o, ,1
1, , , , , , , , , , , , , , ,1
1, , , , , , ,b, , , , , , , ,1
1, ,#, , , , , , , , , , ,*, ,1
1,1,1,1,1,1,1,1,1,1,1,1,1,1,1,1