dim:32
1,1,1,1,1,1,1,1,1,1,1,1,1,1,1,1,1,1,1,1,1,1,1,1,1,1,1,1,1,1,1,1
1, , , ,2, , , , , , , , , , , , , , , , , ,1, , , , , , , , ,1
1, , , ,2, , , , , , , , , , , , , , , , , ,2, , , , , , , , ,1
1, , , ,2, , , , , , , , , , , , , , , , , ,2, , , , , , , , ,1
1, , , ,2, , , , , , , , , , , , , , , , , ,2, , , , , , , , ,1
1, , , ,2, , , , , , , , , , , , , , , , , ,2, , , , , , , , ,1
1, , , ,2, , , , , , , , , , , , , , , , , ,2, , , , , , , , ,1
1, , , ,2, , , , , , , , , , , , , , , , , ,2, , , , , , , , ,1
1, , , ,2, , , , , , , , , , , , , , , , , ,2, , , , , , , , ,1
1, , , ,2, , , , , , , , , , , , , , , , , ,2, , , , , , , , ,1
1, , , ,2, , , , , , , , , , , , , , , , , ,2, , , , , , , , ,1
1, , , ,2, , , , , , , , ,k, , , , , , , , ,2, , , , , , , , ,1
1, , , ,2, , , , , , , , , , , , , , , , , ,2, , , , , , , , ,1
1,1,2,3,2, , , , , , , , , , , , , , , , , ,2, , , , , , , , ,1
1, , , , , , , , , , , , , ,p, , , , , , , ,2, , , , , , , , ,1
1, , , , , , , , , , , , , , , , , , , , , ,2, , , , , , , , ,1
1, , , , , , , , , , , , , , , , , , , , , ,2, , , , , , , , ,1
1, , , , , , , , , , , , , , , , , , , , , ,2, , , , , , , , ,1
1, , , , , , , , , , , , , , , , , , , , , ,2, , , , , , , , ,1
1, , , , , , , , , , , , , , , , , , , , , ,2, , , , , , , , ,1
1, , , , , , , , , , , , , , , , , , , , , ,2, , , , , , , , ,1
1, , , , , , , , , , , , , , , , , , , , , ,2, , , , , , , , ,1
1, , , , , , , , , , , , , , , , , , , , , ,2, , , , , , , , ,1
1, , , , , , , , , , , , , , , , , , , , , ,2, , , , , , , , ,1
1, , , , , , , , , , , , , , , , , , , , , ,2, , , , , , , , ,1
1, , , , , , , , , , , , , , , , , , , , , ,2, , , , , , , , ,1
1, , , , , , , , , , , , , , , , , , , , , ,2, , , , , , , , ,1
1, , , , , , , , , , , , , , , , , , , , , ,2, , , , , , , , ,1
1, , , , , , , , , , , , , , , , , , , , , ,2, , , , , , , , ,1
1, , , , , ,2,4,4,3,5,2, , , , , , , , , , ,2, , , , , , , , ,1
1, , , , , ,2, , , , ,1, , , , , , , , , , ,2, , , , , , , , ,1
1,1,1,1,1,1,1,1,1,1,1,1,1,1,1,1,1,1,1,1,1,1,1,1,1,1,1,1,1,1,1,1