dim:8
health:20
score:300
1,1,1,1,1,1,1,1
1,+, , , , ,*,1
1,2,d,2, , , ,1
1, , ,2, ,k, ,1
1,p, ,2, , , ,1
1, , ,2, , , ,1
1,x,4,2, ,#, ,1
1,1,1,1,1,1,1,1
