dim:64
1,1,1,1,1,1,1,1,1,1,1,1,1,1,1,1,1,1,1,1,1,1,1,1,1,1,1,1,1,1,1,1,1,1,1,1,1,1,1,1,1,1,1,1,1,1,1,1,1,1,1,1,1,1,1,1,1,1,1,1,1,1,1,1
1, , , ,2, , , , , , , , , , , , , , , , , , , , , , , , , , , , , , , , , , , , , , , , , , , , , , , , , , , , , , , , , , ,1
1, , , ,2, , , , , , , , , , , , , , , , , , , , , , , , , , , , , , , , , , , , , , , , , , , , , , , , , , , , , , , , , , ,1
1, , , ,2, , , , , , , , , , , , , , , , , , , , , , , , , , , , , , , , , , , , , , , , , , , , , , , , , , , , , , , , , , ,1
1, , , ,2, , , , , , , , , , , , , , , , , ,2, , , , , , , , , , , , , , , , , , , , , , , , , , , , , , , , , , , , , , , , ,1
1, , , ,2, , , , , , , , , , , , , , , , , ,2, , , , , , , , , , , , , , , , , , , , , , , , , , , , , , , , , , , , , , , , ,1
1, , , ,2, , , , , , , , , , , , , , , , , ,2, , , , , , , , , , , , , , , , , , , , , , , , , , , , , , , , , , , , , , , , ,1
1, , , ,2, , , , , , , , , , , , , , , , , ,2, , , , , , , , , , , , , , , , , , , , , , , , , , , , , , , , , , , , , , , , ,1
1, , , ,2, , , , , , , , , , , , , , , , , ,2, , , , , , , , , , , , , , , , , , , , , , , , , , , , , , , , , , , , , , , , ,1
1, , , ,2, , , , , , , , , , , , , , , , , ,2, , , , , , , , , , , , , , , , , , , , , , , , , , , , , , , , , , , , , , , , ,1
1, , , ,2, , , , , , , , , , , , , , , , , ,2, , , , , , , , , , , , , , , , , , , , , , , , , , , , , , , , , , , , , , , , ,1
1, , , ,2, , , , , , , , ,k, , , , , , , , ,2, , , , , , , , , , , , , , , , , , , , , , , , , , , , , , , , , , , , , , , , ,1
1, ,l, ,2, , , , , , , , , , , , , , , , , ,2, , , , ,l, , , , , , , , , , , , , , , , , , , , , , , , , , , , , , , , , , , ,1
1,1,2,3,2, , , , , , , , , , , , , , , , , ,2, , , , , , , , , , , , , , , , , , , , , , , , , , , , , , , , , , , , , , , , ,1
1, , , , , , , , , , , , , ,p, , , , , , , ,2, , , , , , , , , , , , , , , , , , , , , , , , , , , , , , , , , , , , , , , , ,1
1, , , , , , , , , , , , , , , , , , , , , ,2, , , , , , , , , , , , , , , , , , , , , , , , , , , , , , , , , , , , , , , , ,1
1, , , , , , , , , , , , , , , , , , , , , ,2, , , , , , , , , , , , , , , , , , , , , , , , , , , , , , , , , , , , , , , , ,1
1, , , , , , , , , , , , , , , , , , , , , ,2, , , , , , , , , , , , , , , , , , , , , , , , , , , , , , , , , , , , , , , , ,1
1, , , , , , , , , , , , , , , , , , , , , ,3, , , , , , , , , , , , , , , , , , , , , , , , , , , , , , , , , , , , , , , , ,1
1, , , , , , , , , , , , , , , , , , , , , ,2, , , , , , , , , , , , , , , , , , , , , , , , , , , , , , , , , , , , , , , , ,1
1, , , , , , , , , , , , , , , , , , , , , ,2, , , , , , , , , , , , , , , , , , , , , , , , , , , , , , , , , , , , , , , , ,1
1, , , , , , , , , , , , , , , , , , , , , ,2, , , , , , , , , , , , , , , , , , , , , , , , , , , , , , , , , , , , , , , , ,1
1, , , , , , , , , , , , , , , , , , , , , ,2, , , , , , , , , , , , , , , , , , , , , , , , , , , , , , , , , , , , , , , , ,1
1, , , , , , , , , , , , , , , , , , , , , ,2, , , , , , , , , , , , , , , , , , , , , , , , , , , , , , , , , , , , , , , , ,1
1, , , , , ,m, , , , , , , , , , , , , , , ,2, , , , , , , , , , , , , , , , , , , , , , , , , , , , , , , , , , , , , , , , ,1
1, , , , , , , , , , , , , , , , , , , , , ,2, , , , , , , , , , , , , , , , , , , , , , , , , , , , , , , , , , , , , , , , ,1
1, , , , , , , , , , , , , , , , , , , , , ,2, , , , , , , , , , , , , , , , , , , , , , , , , , , , , , , , , , , , , , , , ,1
1, , , , , , , , , , , , , , , , , , , , , ,2, , , , , , , , , , , , , , , , , , , , , , , , , , , , , , , , , , , , , , , , ,1
1, , , , , , , , , , , , , , , , , , , , , ,2, , , , , , , , , , , , , , , , , , , , , , , , , , , , , , , , , , , , , , , , ,1
1, , , , , ,2,4,4,3,5,2, , , , , , , , , , ,2, , , , , , , , , , , , , , , , , , , , , , , , , , , , , , , , , , , , , , , , ,1
1, , , , , ,2, , , , ,1, , , , , , , , , , ,2, , , , , , , , , , , , , , , , , , , , , , , , , , , , , , , , , , , , , , , , ,1
1, , , ,2, , , , , , , , , , , , , , , , , ,1, , , , , , , , , , , , , , , , , , , , , , , , , , , , , , , , , , , , , , , , ,1
1, , , ,2, , , , , , , , , , , , , , , , , ,2, , , , , , , , , , , , , , , , , , , , , , , , , , , , , , , , , , , , , , , , ,1
1, , , ,2, , , , , , , , , , , , , , , , , ,2, , , , , , , , , , , , , , , , , , , , , , , , , , , , , , , , , , , , , , , , ,1
1, , , ,2, , , , , , , , , , , , , , , , , ,2, , , , , , , , , , , , , , , , , , , , , , , , , , , , , , , , , , , , , , , , ,1
1, , , ,2, , , , , , , , , , , , , , , , , ,2, , , , , , , , , , , , , , , , , , , , , , , , , , , , , , , , , , , , , , , , ,1
1, , , ,2, , , , , , , , , , , , , , , , , ,2, , , , , , , , , , , , , , , , , , , , , , , , , , , , , , , , , , , , , , , , ,1
1, , , ,2, , , , , , , , , , , , , , , , , ,2, , , , , , , , , , , , , , , , , , , , , , , , , , , , , , , , , , , , , , , , ,1
1, , , ,2, , , , , , , , , , , , , , , , , ,2, , , , , , , , , , , , , , , , , , , , , , , , , , , , , , , , , , , , , , , , ,1
1, , , ,2, , , , , , , , , , , , , , , , , ,2, , , , , , , , , , , , , , , , , , , , , , , , , , , , , , , , , , , , , , , , ,1
1, , , ,2, , , , , , , , , , , , , , , , , ,2, , , , , , , , , , , , , , , , , , , , , , , , , , , , , , , , , , , , , , , , ,1
1, , , ,2, , , , , , , , ,k, , , , , , , , ,2, , , , , , , , , , , , , , , , , , , , , , , , , , , , , , , , , , , , , , , , ,1
1, ,l, ,2, , , , , , , , , , , , , , , , , ,2, , , , ,l, , , , , , , , , , , , , , , , , , , , , , , , , , , , , , , , , , , ,1
1,1,2,3,2, , , , , , , , , , , , , , , , , ,2, , , , , , , , , , , , , , , , , , , , , , , , , , , , , , , , , , , , , , , , ,1
1, , , , , , , , , , , , , ,p, , , , , , , ,2, , , , , , , , , , , , , , , , , , , , , , , , , , , , , , , , , , , , , , , , ,1
1, , , , , , , , , , , , , , , , , , , , , ,2, , , , , , , , , , , , , , , , , , , , , , , , , , , , , , , , , , , , , , , , ,1
1, , , , , , , , , , , , , , , , , , , , , ,2, , , , , , , , , , , , , , , , , , , , , , , , , , , , , , , , , , , , , , , , ,1
1, , , , , , , , , , , , , , , , , , , , , ,2, , , , , , , , , , , , , , , , , , , , , , , , , , , , , , , , , , , , , , , , ,1
1, , , , , , , , , , , , , , , , , , , , , ,3, , , , , , , , , , , , , , , , , , , , , , , , , , , , , , , , , , , , , , , , ,1
1, , , , , , , , , , , , , , , , , , , , , ,2, , , , , , , , , , , , , , , , , , , , , , , , , , , , , , , , , , , , , , , , ,1
1, , , , , , , , , , , , , , , , , , , , , ,2, , , , , , , , , , , , , , , , , , , , , , , , , , , , , , , , , , , , , , , , ,1
1, , , , , , , , , , , , , , , , , , , , , ,2, , , , , , , , , , , , , , , , , , , , , , , , , , , , , , , , , , , , , , , , ,1
1, , , , , , , , , , , , , , , , , , , , , ,2, , , , , , , , , , , , , , , , , , , , , , , , , , , , , , , , , , , , , , , , ,1
1, , , , , , , , , , , , , , , , , , , , , ,2, , , , , , , , , , , , , , , , , , , , , , , , , , , , , , , , , , , , , , , , ,1
1, , , , , ,m, , , , , , , , , , , , , , , ,2, , , , , , , , , , , , , , , , , , , , , , , , , , , , , , , , , , , , , , , , ,1
1, , , , , , , , , , , , , , , , , , , , , ,2, , , , , , , , , , , , , , , , , , , , , , , , , , , , , , , , , , , , , , , , ,1
1, , , , , , , , , , , , , , , , , , , , , ,2, , , , , , , , , , , , , , , , , , , , , , , , , , , , , , , , , , , , , , , , ,1
1, , , , , , , , , , , , , , , , , , , , , ,2, , , , , , , , , , , , , , , , , , , , , , , , , , , , , , , , , , , , , , , , ,1
1, , , , , , , , , , , , , , , , , , , , , ,2, , , , , , , , , , , , , , , , , , , , , , , , , , , , , , , , , , , , , , , , ,1
1, , , , , ,2,4,4,3,5,2, , , , , , , , , , ,2, , , , , , , , , , , , , , , , , , , , , , , , , , , , , , , , , , , , , , , , ,1
1, , , , , ,2, , , , ,1, , , , , , , , , , ,2, , , , , , , , , , , , , , , , , , , , , , , , , , , , , , , , , , , , , , , , ,1
1, , , , , ,2,4,4,3,5,2, , , , , , , , , , ,2, , , , , , , , , , , , , , , , , , , , , , , , , , , , , , , , , , , , , , , , ,1
1, , , , , ,2, , , , ,1, , , , , , , , , , ,2, , , , , , , , , , , , , , , , , , , , , , , , , , , , , , , , , , , , , , , , ,1
1,1,1,1,1,1,1,1,1,1,1,1,1,1,1,1,1,1,1,1,1,1,1,1,1,1,1,1,1,1,1,1,1,1,1,1,1,1,1,1,1,1,1,1,1,1,1,1,1,1,1,1,1,1,1,1,1,1,1,1,1,1,1,1