dim:32
1,1,1,1,1,1,1,1,1,1,1,1,1,1,1,1,1,1,1,1,1,1,1,1,1,1,1,1,1,1,1,1
1, , , ,2, , , , , , , , , , , , , ,1, , , , , , , , , , , , ,1
1, ,p, ,2, , , , , , , , , , , , , ,1, , , , ,*, , , , , , , ,1
1, , , ,2, , ,o, , , , , , , , , , ,1, , , , , , , , , ,k, , ,1
1, , , ,2, , , , , , , , , , , , , ,1, , , ,m, , , , , , , , ,1
1,2,3,1,2, , , , , , , , ,l, , , , ,1, , , , ,+, , , , , , , ,1
1, , , ,2, , , , , , , , , , , , , ,1, , , , , , , , ,o, , , ,1
1, , , ,2, , , , , , ,o, , , , , , ,1,2,3,4,4,1,2,3,4, , ,*, ,1
1, , , ,2, , , , , , , , , , , , , , , , , , , , , ,1, , , , ,1
1, , , ,2, , , , , , , , , , , , , , , , , , , , , ,2, , , , ,1
1, ,o, ,2, , , , , , , ,1, , , , , , , , , , , , , ,4, ,#, , ,1
1, , , ,2, , , , , , , ,1, , , , , , , , , , , , , ,4, , , , ,1
1, ,l, ,2, , ,l, , , , ,1, , , , , ,m, , , , , , , ,1,l, , ,#,1
1,1,2,3,2, , , , , , , ,1, , , , , , , , , , , , , ,1, , ,+, ,1
1, , , , , , , , ,1,1,2,4, , , , , , , , , , , , , ,2,3,4,2,1,1
1,o, , , , , , , ,1,1,2,4, , , , , , , , , , , , , , , , , , ,1
1, , , , , , , , ,1,1,2,4,3,4,1,2,1, , ,l, , , , , , , , , , ,1
1, , , ,o, , , , ,1,1,2,4, ,*, , ,1, , , , , , , , , , , , , ,1
1, , , , , , , , ,1,1,2,4, , , , ,1, , , , , ,m, , , , , , , ,1
1, , , , , , , , ,1,1,2,4, , ,#, ,4, , , , , , , , , , , , , ,1
1, , , , , , , , ,1,1,2,4, ,m, , ,4, , , , , , , , , , , , , ,1
1, , , , ,o, , , ,1,1,2,4, , ,#, ,4, , , , , , , , , , , , , ,1
1, , , , , , , , ,1,1,2,4, ,+, , ,2, , , , , , , , , , , , , ,1
1, , , , , , , , ,1,1,2,4,1,3,2,1,2, , , , , , , , , , , , , ,1
1, , , , , ,m, , , , , , , , , , , , , , , , , , , , ,h, , , ,1
1,1,4,2,4,1,2, , , , , , , , , , , , , , , , , , , ,4,4,3,1,2,1
1, , , ,#, ,4, , , , , , , , , , , , , , , , ,o, , ,1, , , , ,1
1, ,h, , , ,1, , , , , , , , , ,l, , , , , , , , , ,1, ,#, , ,1
1, ,#, ,m, ,2, , , , , , , , , , , , , , , , ,1,1,1,2,3,1,1,1,1
1,2, , , , ,2,4,4,3,1,2, , , , , , , ,h, , , ,2, , ,#, , , , ,1
1,5, , , , , , , , , ,3, , , , , , , , , , , ,3, , , , ,#, , ,1
1,1,1,1,1,1,1,1,1,1,1,1,1,1,1,1,1,1,1,1,1,1,1,1,1,1,1,1,1,1,1,1