dim:32
1,1,1,1,1,1,1,1,1,1,1,1,1,1,1,1,1,1,1,1,1,1,1,1,1,1,1,1,1,1,1,1
1, ,k, , ,1, , , , , , , , , , , , , , , , , , , , , , , ,l,*,1
1, ,h, , ,1, , , , , , , , , , , , , , , , , , , , ,4,4, , , ,1
1, , , , ,1, ,o, , , , , , , , , , , , , , , , , , ,4,4, , , ,1
1, , ,h, ,1, , , , , , , , , , , ,o, , , , , , , , , , , , , ,1
1, , , , ,1, , , , , , , ,l, , , , , , , , , , , , , , , , , ,1
1, , , , ,1, , , , , , , , , , , , , , , , , , ,1,1, , , ,l, ,1
1, , , , ,1, , , , , ,o, , , , , , , , , , , , ,2,2, , , , , ,1
1, , ,+,*,2, , , , , , , , , , , , , , , , ,o, ,2,2, , , , , ,1
1, , , ,2, , , , , , , , , , , , , , , , , , , , ,2,4, , , , ,1
1, , , ,3, , , , , , , , , , , , , ,l, , , , , , ,2,4, , , , ,1
1, , , ,2, , , , , , , , , , , , , , , , , , , , , , , , , , ,1
1,1,4,4, , , ,l, , , , ,1,1,1,2,2, , , , , , , , , , , , , , ,1
1, , , , , , , , , , , ,1, , , ,4, , , , , , , , , , , , , , ,1
1, , , , , , , , , , , ,1, ,p, ,3, , , , , , , , , , , , , , ,1
1,o, , , , , , , , , , ,1, , , ,2, , , , , , , , , , , , ,m, ,1
1, , , , , , , , , , , ,1, , , ,5, , , ,l, , , , , , , , , , ,1
1, , , ,o, , , , , , , ,1, , , ,1, , , , , , , , , , , , , , ,1
1, , , , , , , , , , , ,2, ,o, ,1, , , , , , ,m, , , , , , , ,1
1, , , , , , , , , , , ,2, , , ,2,2,2,2,2,2, , , , , , , , , ,1
1, , , , , , , , , , , ,2,1,2, , , , , , ,1, , , , , , , , ,4,1
1, , , , , ,m, , , , , , , , , ,1, , ,+, ,1, , , , , , , ,4, ,1
1, , , , , , , , , , , , , , , ,2,*, , , ,1, , , , , , ,2, , ,1
1, , , , , , , , , , , , , , , ,1,2,3,1,2,1, , , , , , ,2, , ,1
1, , , , , ,m, , , , , , , , , , , , , , , , , , , , , , , , ,1
1, , , , , , , , , , , , , , , , , , , , , , , , , , , ,2, , ,1
1,2, , , , , , , , , , , , , , , , , , , , , , ,o, , ,2,2, , ,1
1,#,2,2, , , , , , , , , , , , ,l, , , , , , , , , , , , , , ,1
1, ,#, ,2, , , , , , , , , , , , , , , , , , , , ,1, , , , , ,1
1, ,l, , ,2,3,1, , , , , , , , , , , ,h, , , , , ,4, , , , , ,1
1, , , , , , ,2, , , , , , , , , , , , , , , , , ,4, , , , , ,1
1,1,1,1,1,1,1,1,1,1,1,1,1,1,1,1,1,1,1,1,1,1,1,1,1,1,1,1,1,1,1,1