dim:32
1,1,1,1,1,1,1,1,1,1,1,1,1,1,1,1,1,1,1,1,1,1,1,1,1,1,1,1,1,1,1,1
1,#, , , ,1, , , , , , , , , , , , , , , , , , , , , , , , , ,1
1, ,l, ,2, , , , , , , ,o, , , , , , , , , , , , , , , , , , ,1
1, ,1,2, , , , , , , , , , , , , , , , , , , , , ,2, , ,h, , ,1
1, , , , , , , , , , , , , , , , , , , , , , , , ,2, , , , , ,1
1, ,*, , , , , , , ,1, , , , , , ,h, , , , , , , ,2, , , , , ,1
1, , , ,2,+, , , , ,2, , , , , , , , , , , , , , ,2, , ,o, , ,1
1, , , ,2,1, , , , ,4, , , , , , , , , , , , , , ,2, ,+, , , ,1
1, , , , , , , , , ,2, , , , , ,o, , , , , , , , , , , , , , ,1
1, , , , , ,o, , , ,1, , , , , , , , , , , , , , ,4, , , , , ,1
1, , ,m, , , , , , , , , , , , , , , , , , , , , ,4, , , , , ,1
1, , , , , , , , , , , , , , , , , , , , ,*, , , , , , , , , ,1
1, , , , , , ,m, , , , , , , , , , , , , , , , , , , , , , , ,1
1, , , , , , , , , , , ,*, , , , , , , , , , , , , , , , , , ,1
1,1,1,1,2,2,2,2,4,4,1,2,1, , , , , , , , , , , , , , , , , , ,1
1,#, , , , , , , , , , , , , , , , , , , , , , , ,4, , , , , ,1
1, ,p, , , , , ,o, , , , , , , , , , , , , , , , , , , , , , ,1
1, , , , , , , , , , , , , , , , , , , , , , , , , , , , , , ,1
1, , , , , , , , , , , ,o, , , , , ,2, , , , , , , , ,h, , , ,1
1, , , , , , , , , , , , , , , , , ,1, , , , , , , , , , , , ,1
1, , , , , , ,o, , , , , , , , , ,2,2, ,4,4,4,4,4,4, , , , , ,1
1, , ,*, , , , , , , , , , , , , ,2, , ,2,l, , , ,4, , , , , ,1
1,1,2,2,2,2,4,4,1,4, , , , , , ,1, , , ,2, , ,o, ,4,2,2, , , ,1
1, , , , , , , , ,4, , , , , , , , , , ,2,#, , , , ,*,3, , , ,1
1, , ,#, , , , , ,1, , ,l, , , , , , , ,1, , ,k, , , ,4, , , ,1
1, , ,#, , , , , ,2, , , , , , , , , , ,1, , , , , ,#,2, , , ,1
1, , , , , , , , ,2,4,4,1, , , , , , , ,1, , ,l, , , ,1, , , ,1
1, , , , , , , , , , , ,1, , , , , , , ,1,3,4,2,2,1,2, , , , ,1
1,4, , , , , , , , , , ,1, , , , , , , , , , , , , , , , , , ,1
1,5, , ,b, , , , , , , ,3, , , , ,h, , , , , , , , , , , , , ,1
1,2, , , , , , , , , , ,1, , , , , , , , , , , , , , , , , , ,1
1,1,1,1,1,1,1,1,1,1,1,1,1,1,1,1,1,1,1,1,1,1,1,1,1,1,1,1,1,1,1,1